##############################
# D @                  !     # 
#@@@@   /   ####             # 
#                      !     # 
##############################