##############################
# D @                  !     # 
#@@@@     / ####             # 
#                      !     # 
##############################