##############################
#   @  !          !          #
# @@@      /!  ####     !    #
#             D      !       #
##############################