##############################
# / @    #        ! #        # 
# @@@    #  ####### #        # 
#   #    #  #       #   !    # 
#####    #  #       # ########
#       @@@#@@@@    #        #
#        #@@@@@@    #        #
#        #          #  ##@@@@#
#      ! #          !  @  !#@#
############################D#