##############################
#   @             !          # 
# @@@     / ####             # 
#   D                   !    # 
#                            #
#           !                #
#                            #
#                            #
#                   !        #
##############################