##############################
#   @                        #
# @@@        ####            #
#           / D #            #
##############################